####################
#  ##   #      #   #
#  ##   #    # # # #
#       #    #   # #
#   p        ##### #
#                  #
# ############## ###
#   #
# # #
#   #
#####